


NO ./textures/xpm/wall1.xpm
EA ./textures/xpm/wall2.xpm
SO ./textures/xpm/wall3.xpm
WE ./textures/xpm/wall4.xpm

F 0,0,255
C 204,0,102

        11111111111
        10000000001
1111111110000000001
1000000000000000001111111111
1000000000000000000000000001
1000000000000000000000000001    1111
1000000000111111110000000001    1001
10000000001      10000000001    1111
10000001111      10000000001
1000000000111111110000000001
1000000000000000000000000001
1000000000000000000000000001
1111111100000000000011100001111111111
       111000000000010000W00010000001
       100000000000000000000010000001
11111111000001111110011100000D0000001
1000000D000001 1000001 10000010000001
11111111111111 1111111 11111111111111