


NO ./textures/xpm/wall1.xpm
EA ./textures/xpm/wall2.xpm
SO ./textures/xpm/wall3.xpm
WE ./textures/xpm/wall4.xpm

F 0,0,255
C 204,0,102

11111111111
1S000000001
10000000001
10000000001
10000000001
10000000001
11111111111