


NO ./textures/xpm/wall1.xpmd
SO ./textures/xpm/wall1.xpm
WE ./textures/xpm/wall1.xpm
EA ./textures/xpm/wall1.xpm

F 0,255,0
C 204,0,102


11111111111111111111111111111
1000000001    1100000000000N1
1000000001    100000000000001
10010000011111100000001111111
101100000111000000000001
10000000001100000111011111111
11110111111111011100000010001
11110111111111011101010010001
1100000011010101110000010001
10000000000000001100000000001
10000000000000001101010010001
11000000000101011111011110001
11000111011101000001111010001
11111111111111111111111111111



