


NO ./textures/xpm/wall1.xpm
EA ./textures/xpm/wall1.xpm
SO ./textures/xpm/wall1.xpm
WE ./textures/xpm/wall1.xpm

F 0,0,255
C 204,0,102

          111111111
    111111100000001
    100000000000111
11111000000000001
1000000000S000001
100000000000D0001
10001111111100001
10001       10111
10001       101
100011111111101
100000000000001
111111111111111