


NO ./path_to_the_north_texture
SO ./path_to_the_south_texture
WE ./path_to_the_west_texture
EA ./path_to_the_east_texture

F 220,100,0
C 225,30,0


11111111111111111111111111111
1000000001    110000000000001
1000000001    100000000000001
10010000011111100000001111111
101100000111000000000001
10000000001100000111011111111
11110111111111011100000010001
11110111111111011101010010001
11000000110101011100000010001
10000000000000001100000000001
10000000000000001101010010001
11000000000101011111011110N01
11000111011101000001111010001
111111111111111111111111111



