NO ./textures/xpm/wall1.xpm
EA ./textures/xpm/wall2.xpm
SO ./textures/xpm/wall3.xpm
WE ./textures/xpm/wall4.xpm
C 100,100,100
F 100,100,100

1111111111111111111111111111111111111111111111111111111111111111111111111111111111111111111111111111
1010001000000001000000100100000000101000000010100000000000000000000000100000000000100000000001010001
1000100110011000000000101000101001000001001000000000000000S00000000000100100011001000111001010000111
1001010001000110111010100000101001000010000111000000000000000000000000101001000100010000001010010001
1101000101010001000100111110101110001010010000000000000000100000000000010000010010001001101000011101
1001001001000101010010000000100000110010001100000000000000000000000000100010100100001010000011100001
1010000001000101001001101100000010001011000000000000000000000000000000101000100101110010010100001001
1001001000110100010100010001000101001000100001001000100001000110000100001111110100000010100100110001
1000101001000010100001000100010000101010010000111100011100001000110101110000100110010000000101000011
1010010000001001000110000110010010100101001101001001000010001010000010000010100001000010001001001001
1001000111101101001001000001001100110000100001000001001010001001111100100010000101001101100101001101
1001001000000000001000101100100010001110100000011001010010110000000010011101010001100000001001010001
1000100110010010101010100010010010100000000011100100100011000001001000100001001010000001000100000001
1001001000010001001010001010010001000101000100001001001100001001110000001110001010110001001110010101
1001010010101000010010010000101100010100110001100010010001001010001011100001000011001010000100101001
1101010001000100100101001100000010011001001000011100010110001010100100010100100000000100101001001001
1001001100010010001000000001101001000001001110100001010001100000100101000100111101110000100001001101
1000100010001000010010011000010001111001000001001010011000010110001001100010000010000010010100000001
1011111001100000010001100010100010000101010001010100100101010000010010001000001010101100010011111111
1000100100001100100100010010001100000101001010000010100010001101001010010011110010010011001000000001
1000000111010011001001010001110010101001001010001010000100010000010010010000001001100000100110111001
1100110000010000100010000010001000001000101011001001001000111000010100010111100100000100010001000101
1001001101010100111010001010100001000100100000110001010101010010000100010000000011101010100001000101
1010100000100101000010010000100100011001010110000101000101000101001000000010011000010000100100010101
1000010011001001001001010101000100000001000001010101011001011000101111010010000111100010001010010001
1001000100101010010100010000001000110010011100100000100001000010100000100010110000001001010001001001
1000101000100000100000101000000010000000000010100001001111111000010010001010000110010001010100101011
1001001010110010001001001001000000110100110100001100000001000100010101010010100001010100000010001001
1110001000000100100000000000101100000100000001000010000100010011001000010010011101010010001100000101
1000000101100000011100001100010010000101100101001010010100101000100011100101000010011010010001010001
1011000100010100100010010010000011011000001001010010100111000110010100001000001001000010000001001001
1000111001001000001001010011101000000101001110010100100000110001000101000101100100100111111001101001
1010000010100100100000100000010000110010000000100100100110000100101001010010010010000010000010001001
1001001000100100011110001110010000001001001100000010111001110011000101001000001011101000110000101001
1000001100010010100001000001001111101100010001001010000000001100010000100100001000010111001100010011
1110010001010010101001100100000000000010100010010010001000000001010011110100010100010000010000100001
1001100100001001000100010000011000011001001101000111000100111110010100100100010100000111010011000101
1000001001111100100101001111100001100101000001110010010101000000010000001001000000111000100000001001
1010000010001010001010000000010010010001010110001000100101011001011010000000100001000010101111110001
1001110010100011100001011111010010001000001000100100010101000100000010010010110010010000100000001011
1100001010010100010100100000010100110000110010010010100010100010111000001000001100010100100111100001
1000100101010101000010000010100100000111000101001001001000010010000111110110000001100100101000010101
1000010000010100100101010001001001100000011000100100001001010010010000000000111000001001000001010101
1000001000010010100100001010001010000111100000000010001110000000001101111101000101000010001100100101
1000010100100100011000100100100010101000000111011010110001111101010010000000010101001001100010101001
1011000011010000100010010001010100110010011000100010000100000010010100001011000101010010010001000001
1000101000011001000011000010001001000010100010011100001111111010010000001000101001000100010100010101
1010001111000001001000101000000001001010100001000001000100000010011100010010101010011001000111000101
1001110000100110010100100100111010010100111010110100100100000100100010001000100000000010001000111001
1010001001001000100100010001000100000101000010001010111010001000001000100101010100001101001010000011
1000100010000110010010100101010001010001000010100010000000100001110001000100000011110000110011111001
1000100010010001001010110001010010001010000010100000100100100100000010000000101000000110000000000101
1010010010100001001010001010001000010010001100101011011000010001000011000111001110001001001111001001
1010000010010010101010001000001111101001100010100100000001000100101000101000010001101000100000010001
1001100101001000001010100000010000000100010010111000100110100011001100100010100100001010010100100011
1010010000100110000010100110010001101001001010000001000000100100000010010100101000001001010010010001
1000001010010001001000111001010010010001001001000010010010011001100001010000100011110100001001010101
1111001010001100101110000000000100000100100101011000001000100100001110011010010000000010101001010011
1000101001100010010001111100110101111000110100100001001100110010010001000010100011100010000101001001
1010000110001001000100000010001000000010000100100100100000001001010100001100100100010001010001101001
1010010000100000100100001001100100110001110101000011000000101001010100010001001001001100011110001001
1011001100001111000101010100010011000010001000001000010001001010000111010101001010100010000001010001
1000100011100000100101000010011000001100100111000011001010010001001000100101001010010001100110000101
1010111000010100100100100101000111010001010000010100100100100100010010000100001010001000010000000101
1010000100000101000010101000110000100010001110001000010010100010100101011110010010100110010010001001
1011010111101001000100101010000010001010100000100001010000011010010000100100100010010001010100010001
1000100000010001100100100000101101010010010011011000001000100101000010100000100101010010010001000101
1100000001001000001000010101000001001010010000000010101010100000001000100100010101001001001000110001
1011110001100111001001010100011100100010010101111100001000101100100101000101010100001100100110001001
1000000110010000010010010101100000010001010010000001110100100011001001000010100100010010010001100001
1000010000000010000101100010001000010100001000010010000000101000101010010010100010000001000100011001
1000010001100100110000001000100011001000110000100100110010001110010010100000111001111100001011000011
1000100010001000001001000111000000100010001000010000001011000001000100001110000010000010100000010001
1110101010001100101001011000010010100100101101101111101000010110001000100001001000100000100111010101
1000110010100001001010000010000100101001000010000000010100011001000101010100101001011011001000100101
1000000101000010001010010100101001001000100010010111000010000000010000010101001000000100010010100011
1011011000001100001010001000110001000100100100101000111001101110001011100100001111100011000100001001
1000100000100001110000100101000001010010100010101010000010010001010000000000110000011000101000000101
1000010101010110001100011001001110100010000100100011010000010101000010011000000010000110101000010001
1010100000010000100001000010010000011001010101011100100011000100101011100000101101110000101000001001
1011001010001111011110101010101011000101000001000000001000000101000100000110010000001010101001110011
1000001001010000000000100100100000110001001110101000110011110101011000100001100111100100101010000001
1110110001010101001111110000100110001001110000001001000100000100100001011100001000010100101010101001
1001000101010100010000101000001001101010001101010001010100011010001010000010100000010110101010101101
1000010001001010100110000001000010000100100001010010010010100001000100010001001010010001000100100011
1001100101010000101000011010110010010000110010010010001000100100010000101100010001101000010000101001
1010001010010111000100100100000000100111001010100101000101000100001000100001000100000100010100011101
1001000010100000001001000001101101000000001010001000101001001001100100010010010110010000100110001001
1000011100100011100001001000000010001110001010100010101000010000010001000001010000001000110001001011
1010100001010100010101010001110010100000010011000100001010010011001110100110010011100000001001010001
1010100100000100010010001110001000110100100100100011010011100100100000010001000100000111001001100101
1010001000100110000010110000100101001001001000101000100000001000010011010100011001110000001000000001
1001001001000000101010000000010010001000101000000010001110100010010100000011000010001111001001110101
1100001001001110010011110110001010010010100101101101110001010100100010001000101010100000100010001001
1011100101010001000000001000010010000100100100010000000000001001000100100000101100000010010100100001
1000000100010101000110100000100100101001010101010101001111110010101000111011000001110011001001011111
1010011001100000011000010100101000100001000100010100110000000100001000000100010010000100101001000001
1001100010001010100111100101001010010100101000100100000100111000110000000101011100101000001000111001
1000000000100010000000000100001000010000001010000010000000000001000100000001000001000001000000000001
1111111111111111111111111111111111111111111111111111111111111111111111111111111111111111111111111111
